000000000000000000000000000000000000000000000000000000000000
000000000000234023340000000002334000000000233333340000002400
000000002111111111111111110111111110001111111111111000111110
000000051111111111111111111111111110011111111111111100111100
000003111111111111111111111111111111111111111111111111111100
000511111111111111111111111111111111111111111111111111111100
005111111100010011111111111111111111111111111111111111111000
001111111000000000111111111111111111110011111111111111110000 
